HHHHHHHHHHHHHHHHHHHHHHHHH
HHHHHHHHHHHHHHHHHHHHHHHHH
HHHHHH*HHHHHHHHHHHHHHHHHH
HHHHHH,HHHHHHHH,HHHHHHHHH
HHHHHHH,______,H,HHHHHHHH
HHHHHHHH,HHHH,HHH,HHHHHHH
HHHHHHH,HHHHH,____,HHHHHH
HHHHHHHH,H,,,,HHHHH,HHHHH
HHHHHHHHH,HHHHHHHHHH#HHHH
HHHHHHHHHHHHHHHHHHHHHHHHH
HHHHHHHHHHHHHHHHHHHHHHHHH
HHHHHHHHHHHHHHHHHHHHHHHHH