HHHHHHHHHHHHHHHHHHHHHHHHH
HHHHHHHHHHHHHHHHHHHHHHHHH
HHHHH*HHHH____\HHHHHHHHHH
HHHHH|HHH/HHHHH\HHHHHHHHH
HHHHH|HH/HH#_\H|HHHHHHHHH
HHHHH|HH|HHHH|H|HHHHHHHHH
HHHHH\HH|____/H/HHHHHHHHH
HHHHHH\HHHHHHH/HHHHHHHHHH
HHHHHHH\_____/HHHHHHHHHHH
HHHHHHHHHHHHHHHHHHHHHHHHH
HHHHHHHHHHHHHHHHHHHHHHHHH
HHHHHHHHHHHHHHHHHHHHHHHHH