HHHHHHHHHHHHHHHHHHHHHHHHHHHHHHHHHH
HHHHHHHHHHHHHHHHHHHHHHHHHHHHHHHHHH
HHHHHH|____________________|HHHHHH
HHHHHH|,,*,,,,|,,,,,,,,,,,,|HHHHHH
HHHHHH|,,,,,,,|,,,,,,,,#,,,|HHHHHH
HHHHHH|,,,,,,,,,,,,,,,,,,,,|HHHHHH
HHHHHH|,,,,,,,,,,,,,,,,,,,,|HHHHHH
HHHHHH|,,,,,,,,,,,,,,,,,,,,|HHHHHH
HHHHHH|,,,,,,,,,,,,,,,,,,,,|HHHHHH
HHHHHH|_______,,___________|HHHHHH
HHHHHHHHHHHHHHHHHHHHHHHHHHHHHHHHHH
HHHHHHHHHHHHHHHHHHHHHHHHHHHHHHHHHH