HHHHHHHHHHHHHHHHHHHHHHHHH
HHHHHHHHHHHHHHHHHHHHHHHHH
HHHHHH|_____|HHHHHHHHHHHH
HHHHHH|,,,,*|HHHHHHHHHHHH
HHHHHH|,,,,,\HHHHHHHHHHHH
HHHHHHH\,,,,,\HHHHHHHHHHH
HHHHHHHH\,,,,,\HHHHHHHHHH
HHHHHHHHH\,,,,,\HHHHHHHHH
HHHHHHHHHH\,,,,|HHHHHHHHH
HHHHHHHHHHH\,,,|HHHHHHHHH
HHHHHHHHHHHH\,,|HHHHHHHHH
HHHHHHHHHHHH/,,|HHHHHHHHH
HHHHHHHHHHH/,,,|HHHHHHHHH
HHHHHHHHHH/,,,,|HHHHHHHHH
HHHHHHHHH/,,,,,|HHHHHHHHH
HHHHHHHH/,,,,,/HHHHHHHHHH
HHHHHHHHHH|,|HHHHHHHHHHHH
HHHHHHHHHH|#|HHHHHHHHHHHH
HHHHHHHHHH___HHHHHHHHHHHH
HHHHHHHHHHHHHHHHHHHHHHHHH